map = {
	{ 6, 6, 6, 6, 6, 6, 5, 5, 6, 6, 6, 6, 6, 6, 6, 0, 0, 0, 0, 0, 0, 0, 0, 0, 0, 0, 0, 0, 0, 0, 0, 0 },
	{ 6, 6, 6, 6, 6, 6, 5, 5, 6, 6, 6, 6, 6, 6, 6, 0, 0, 0, 0, 0, 0, 0, 0, 0, 0, 0, 2, 2, 2, 2, 0, 0 },
	{ 6, 6, 6, 6, 6, 6, 5, 5, 6, 6, 6, 6, 6, 6, 6, 0, 0, 0, 0, 2, 2, 0, 0, 0, 2, 2, 5, 5, 5, 5, 5, 0 },
	{ 11, 11, 11, 11, 11, 11, 11, 11, 11, 11, 11, 11, 11, 11, 11, 11, 0, 0, 2, 5, 5, 2, 2, 2, 5, 5, 5, 2, 2, 0, 5, 5 },
	{ 0, 10, 10, 10, 10, 10, 10, 10, 10, 10, 10, 10, 10, 0, 0, 0, 0, 0, 2, 2, 5, 5, 5, 5, 5, 5, 2, 0, 0, 0, 0, 2 },
	{ 0, 10, 10, 10, 10, 10, 10, 10, 10, 10, 10, 10, 10, 0, 0, 0, 0, 0, 2, 2, 5, 2, 2, 2, 2, 2, 0, 0, 0, 0, 0, 0 },
	{ 0, 10, 10, 10, 10, 10, 10, 10, 10, 10, 10, 10, 10, 0, 2, 0, 0, 0, 2, 2, 5, 2, 0, 0, 0, 0, 0, 0, 0, 0, 0, 0 },
	{ 0, 10, 10, 10, 10, 10, 10, 10, 10, 10, 10, 10, 10, 2, 5, 2, 0, 0, 2, 2, 5, 2, 2, 0, 0, 0, 0, 0, 0, 0, 0, 0 },
	{ 0, 10, 10, 10, 10, 11, 11, 11, 11, 10, 10, 10, 2, 2, 5, 5, 2, 0, 0, 2, 5, 2, 0, 0, 0, 0, 0, 2, 2, 2, 0, 0 },
	{ 0, 10, 10, 10, 10, 11, 11, 11, 11, 10, 10, 2, 5, 5, 5, 2, 2, 2, 0, 2, 5, 5, 2, 0, 0, 0, 2, 2, 2, 5, 2, 0 },
 
}

colmap = {
	{ 0, 0, 0, 0, 0, 0, 0, 0, 0, 0, 0, 0, 0, 0, 0, 0, 0, 0, 0, 0, 0, 0, 0, 0, 0, 0, 0, 0, 0, 0, 0, 0 },
	{ 0, 0, 0, 0, 0, 0, 0, 0, 0, 0, 0, 0, 0, 0, 0, 0, 0, 0, 0, 0, 0, 0, 0, 0, 0, 0, 0, 0, 0, 0, 0, 0 },
	{ 0, 0, 0, 0, 0, 0, 0, 0, 0, 0, 0, 0, 0, 0, 0, 0, 0, 0, 0, 0, 0, 0, 0, 0, 0, 0, 2, 2, 2, 2, 2, 0 },
	{ 2, 2, 2, 2, 2, 2, 2, 2, 2, 2, 2, 2, 2, 2, 2, 2, 0, 0, 0, 2, 2, 0, 0, 0, 2, 2, 0, 0, 0, 0, 0, 2 },
	{ 0, 0, 0, 0, 0, 0, 0, 0, 0, 0, 0, 0, 0, 0, 0, 0, 0, 0, 0, 0, 0, 2, 2, 2, 0, 0, 0, 0, 0, 0, 0, 0 },
	{ 0, 0, 0, 0, 0, 0, 0, 0, 0, 0, 0, 0, 0, 0, 0, 0, 0, 0, 0, 0, 0, 0, 0, 0, 0, 0, 0, 0, 0, 0, 0, 0 },
	{ 0, 0, 0, 0, 0, 0, 0, 0, 0, 0, 0, 0, 0, 0, 0, 0, 0, 0, 0, 0, 0, 0, 0, 0, 0, 0, 0, 0, 0, 0, 0, 0 },
	{ 0, 0, 0, 0, 0, 0, 0, 0, 0, 0, 0, 0, 0, 0, 2, 0, 0, 0, 0, 0, 0, 0, 0, 0, 0, 0, 0, 0, 0, 0, 0, 0 },
	{ 0, 0, 0, 0, 0, 2, 2, 2, 2, 0, 0, 0, 0, 0, 0, 2, 0, 0, 0, 0, 0, 0, 0, 0, 0, 0, 0, 0, 0, 0, 0, 0 },
	{ 0, 0, 0, 0, 0, 0, 0, 0, 0, 0, 0, 0, 2, 2, 0, 0, 0, 0, 0, 0, 0, 2, 0, 0, 0, 0, 0, 0, 0, 2, 0, 0 },
 
}

return map, colmap